16
20
..||||||||||||||||||
..|.....||||||.|...|
..|................|
..||||||||||...|...|
...........|...|...|
...........|...|...|
.|...|||||||||||...|
.|...|.....|.......|
.|...|.....|.......|
.|...|.............|
.....|.............|
|||..|||||||||.....|
|......|......||||||
|......|......|.$..|
|..................|
||||||||||||||||||||
